WWWWWWWWWWWWWWW
W1111111111111W
W11WWW11111111W
WWLW1111111111W
WP1W1111111FW1W
WW1W11WWWWWWWLW
W1BWWW111B1M11W
W1111M1W1B1ML1W
WWWWWWWWWWWWWWW
---------------
111111111111111
111111111111111
111111111111111
111111111111111
111111111111111
111111111111111
111111111111111
111111111111111
111111111111111