WWWWW1W1111WWWW
W1B1B111111W11F
W1W1W1W1WWKW111
WPW11111W11W111
WWWWWWWWWWLWLWW
W11111111111111
W11111111111111
W111M1111111111
W11111111111111
---------------
111111111111111
111111111111111
111111111111111
111111111111111
111111111111111
111111111111111
111111111111111
111111111111111
111111111111111