WWWWWWWWWWWWWWW
W1111111111111W
W1111111111K11W
W11111P1111111W
W11111111F1111W
W1111111111111W
W11111111L1111W
W1111111111111W
WWWWWWWWWWWWWWW
---------------
111111111111111
111111111111111
111111111111111
111111111111111
111111111111111
111111111111111
111111111111111
111111111111111
111111111111111