111111W1W111111
111111W1W111111
111111W1W111111
111111B1B111111
11P111B1B111F11
111111B1B111111
111111W1W111111
111111W1W111111
111111W1W111111
---------------
..11111111111..
.1111111111111.
111111111111111
111111111111111
111111111111111
111111111111111
111111111111111
.1111111111111.
..11111111111..