W1111111111WWWW
W1111111111W11F
W1WWWWWWWWKW111
WP1111W1111W111
WLWWWWWWWWWWLWW
W11111111111111
W11111111111111
W11111111111111
W11111111111111
---------------
111111111111111
111111111111111
111111111111111
111111111111111
111111111111111
111111111111111
111111111111111
111111111111111
111111111111111