WWWWWWWWWWWWWWW
W1111WM1MW1111W
WWWWWWBKBWWWWWW
WWWWWW111111LFW
WMB111LLLWWWWWW
W1BM11MKM111BMW
W11111WWW111MBW
W111111P111111W
WWWWWWWWWWWWWWW
---------------
111111111111111
1.1.1111111.1.1
111111111111111
1.1.1111111.1.1
111111111111111
1.1.1111111.1.1
111111111111111
1.1.1111111.1.1
111111111111111