11111111111W111
11111111111W1F1
1111111P111W111
BWB11111111WWLW
1K1111111111111
BWB111111111111
111111111111111
111111111111111
111111111111111
---------------
111111111111111
111111111111111
1111111T1111111
1111111T1111111
1RTTTTTTTTTTTT1
1111111T1111111
1111111T1111111
111111111111111
111111111111111