111111111111111
111111111111111
WWWWWWWWWWWWWWW
11B1BW111111111
P1B1111W1111F11
11B1WBW11111111
WWWWWWWWWWWWWWW
111111111111111
111111111111111
---------------
111111111111111
111111111111111
111111111111111
111111111111111
111111111111111
111111111111111
111111111111111
111111111111111
111111111111111