WWWWWWWWWWWWWWW
P11111111111111
WW1111111111111
1W1111111111111
1WWWWWWWWWWWWWW
111111111111111
1111111F1111111
111111111111111
111111111111111
111111111111111
---------------
111111111111111
111111111111111
111111111111111
111111111111111
111111111111111
111111111111111
111111111111111
111111111111111
111111111111111