PP111111111W111
11111111111W111
11111111111W111
111111WWWWWW111
111111K1111L1F1
111111WWWWWW111
11111111111W111
11111111111W111
11111111111W111
---------------
111111111111111
111111111111111
111111111111111
111111111111111
1TTTTTTTTTTTTT1
111111111111111
111111111111111
111111111111111
111111111111111