WWWWWWW1111WWWW
W1B1B111111W111
W1W1W1W1WWKW1F1
WPW11111W11W111
WWWWWWWWWWLWLWW
W11M11111111111
W1KM11111111111
W11M11111111111
W11M1111111B111
---------------
111111111111111
111111111111111
111111111111111
111111111111111
111111111111111
111111111111111
111111111111111
1111111111...11
1111111111.1.11