WWWWWWWWWWWWWWW
W11111MFW11111W
W1W1WWWWW11M11W
W1W111111MMM11W
W1W1WWWWWBWBWWW
W1W1W111B1WB11W
W1W1WWW1W1WB11W
WP111111111111W
WWWWWWWWWWWWWWW
---------------
111111111111111
1.1.1111111.1.1
111111111111111
1.1.1111111.1.1
111111111111111
1.1.1111111.1.1
111111111111111
1.1.1111111.1.1
111111111111111