WWWWWWWWWWWWWWW
P111111111111LF
1WWWWWW1WWWWWWW
1W1111W1W11111W
1W1111WKW11111W
1W1111W1W11111W
1WWWWWW1WWWWWWW
111111111111111
WWWWWWWWWWWWWWW
---------------
111111111111111
111111111111111
111111111111111
111111111111111
111TT11111TTT11
111111111111111
111111111111111
111111111111111
111111111111111