WWWWWWWWWWWWWWW
W1111111111111W
W11P1111111111W
W1WW11LLL11WW1W
W1B11WLFLW11KMW
W1WW11LLL11WW1W
W1111111111111W
W1111111111111W
WWWWWWWWWWWWWWW
---------------
111111111111111
111111...111111
1..111111111..1
1.11111111111.1
111111111111111
1.11111111111.1
1..111111111..1
111111...111111
111111111111111