11111111111W111
11111111111W1F1
1111111P111W111
1WWW1111111WWLW
11K111111111111
1WWW11111111111
111111111111111
111111111111111
111111111111111
---------------
111111111111111
111111111111111
1111111T1111111
1111111T1111111
1TRTTTTTTTTTTT1
1111111T1111111
1111111T1111111
111111111111111
111111111111111