1111111K1111111
111111111111111
111F11111111111
111111111111111
111111111111111
111111111111111
11P111111111111
111111111111111
111111111111111
---------------
111111111111111
111111111111111
111100000011111
111100000011111
111100000011111
111111111111111
111111111111111
111111111111111
111111111111111